R 8000 6000

NO ./textures/brick.xpm
EA ./textures/kandinsky.xpm
SO ./textures/stone.xpm
WE ./textures/cat.xpm
S ./textures/barrel.xpm

F 2,237,0
C 2,237,245

        1111111111111111111111111
        1000000000110000000000001
        101100200111000000N000001
        1001000000000020200000001
111111111011000001110000000000001
100000000011000001110111111111111
11110111111111011100000010001
11110111111111011101010010001
11000000110101011100000010001
10002000000000001100000010001
10000000000000001101010010001
1100000111010101111101111000111
11110111 1110101 101111010001
11111111 1111111 111111111111
